NO textures/north_texture.xpm
SO textures/south_texture.xpm
WE textures/west_texture.xpm
EA textures/east_texture.xpm

F 220,100,0
C 225,30,0
11     1           1
1111111111111111111111111111111111111111111111111111111111111
 1                  
 1 111111111111111 11111111
 1 1             1      
 1 1 11111111111 1 1111111
11 1 1           1 1       
 1 1 1 11111111111 111111111
 1
 1
 1
 1
 1
 1
 1
 1
 1
11
 1
 1
 1
 1
11
 1
 1
 1
 1
 1
 1
 1
 1
 1
 1
11
 1
 1
 1
 1
11111
11
