NO textures/laink.xpm
SO textures/laink.xpm
WE textures/laink.xpm
EA textures/laink.xpm
DO textures/laink.xpm
TP textures/laink.xpm

F 222,184,135
C 135,206,235

        1111111111111111111111111
        1000000000110000000000001
        1011000001110000000000001
        10010000000P0000000000001
1111111110110000011100000000000N1
10000000001100000111P111111111111
11110111111111011100000010001
1111P111111111P11101010010001
11000000110101010000000010001
100000000000000000000000P0001
10000000000000000001P10010001
1100000111010101111101111000111
11110111 1110101 101111010001
11111111 1111111 111111111111
