NO textures/Grass_32x32.xpm
SO textures/Grass_32x32.xpm
WE textures/Grass_32x32.xpm
EA textures/Grass_32x32.xpm
DO textures/Grass_32x32.xpm
TP textures/door_32x32.xpm

F 222,184,135
C 135,206,235

11     1            1     1     1      1           1     11
11111111111111111111111111111111111111111111111111111111111
 10000000000000000P000000000P10000000000000000000000000001
 10111111111111111P111111111P10101111111111101111111111101
 101000000000000010000000001010100000000000000000000000101
 101011111111111P10111111101010111111111111101111111110101
11010100000000000101000000010101000000000001000000000101011
 101010111111111110111111111010101111111110101111111010101
 101010100000000000000000000010101000000010101000001010101
 101010101111111111111111111110101011111010101011101010101
 101010101000000000100000000010101000001010101000101010101
 101010101011111110101111111010101111101010101110101010101
 1010101010100000100010000010001000000010101000101010101011
 101010101010111011111011101111111110111011111010101010101
 101010101010100000000000000000000000000000001010101010101  111111111111
 101010100010101P1111111P111111P1111111111P101P10101010101  100000000001
110101011111P101000000000000000000000000000101000101010001  100000000001
 101010000000101011111P1111P111P1111P1111101011111010111011 100000000001
 101P1P11111110101000000000000000000000001010100000001000111100000000001
 1000100000000010P00000000000N00000000000P010101111111000P00300000000051
 11111111111110101000000000000000000000001010100000001000111100000000001
 100000100000001011111P1111P111P1111P1111101011111111111011 100000000001
1101110101111100000000000000000000000000000101000000010001  100000000001
 100010101000111110111111111111011111111010101011111010101  100000000001
 101010101010000010001000000010000000000010001014001010101  111111111111
 101010101011111010101011111010111111101010111011101010101
 1010101010000010101010000010101000000010101000101010101011
 101010101111101010101111101010101111101010101110101010101
 101010100000001010100000101010100000001010100000101010101
 101010111111111010111110101010111111111010111111101010101
 101010000000000010000000101010000000000010000000001010101
 101010111111111111111111101011111111111111111111111010101
11010100000000000000000000010000000000000100000000000101011
 101011111111111111111111111110111111111010111111111110101
 101000000000000000000000001000000000000000000000000000101
 101111111111111011111111101011111111111110111111111111101
 100000000000000010000000001000000000000000000000000000001
11111111111111111111111111111111111111111111111111111111111
11     1            1     1     1      1           1     11
 




































 
11111
10001
10601
10001
11111
