NO textures/Brick_Wall_Cracked_64x64.xpm
SO textures/Green_Wall_Rocks_64x64.xpm
WE textures/Wooden_Floor_Horizontal_64x64.xpm
EA textures/Wooden_Floor_Vertical_64x64.xpm
DO textures/door_64x64.xpm

F 222,184,135
C 135,206,235

        1111111111111111111111111
        1000000000110000000000001
        1011000001110000000000001
        1001000000000000000000001
1111111110110000011100000000000W1
100000000011000001110111111111111
11110111111111011100000010001
11110111111111011101010010001
11000000110101010000000010001
10000000000000000000000000001
10000000000000000001010010001
1100000111010101111101111000111
11110111 1110101 101111010001
11111111 1111111 111111111111
